NVDA	Nvidia
INTC	Intel
AMD	Advanced Micro Devices
TSLA	Tesla, Inc.
AAPL	Apple Inc.
PLTR	Palantir Technologies
F	Ford Motor Company
AMZN	Amazon
WBD	Warner Bros. Discovery
PFE	Pfizer
SMCI	Supermicro
PSKY	Paramount Skydance Corporation
BAC	Bank of America
GOOGL	Alphabet Inc. (Class A)
T	AT&T
KEY	KeyCorp
PCG	PG&E Corporation
AMCR	Amcor
TTD	Trade Desk (The)
HBAN	Huntington Bancshares
CSCO	Cisco
CMCSA	Comcast
KVUE	Kenvue
UBER	Uber
MU	Micron Technology
MSFT	Microsoft
GOOG	Alphabet Inc. (Class C)
UNH	UnitedHealth Group
CMG	Chipotle Mexican Grill
KMI	Kinder Morgan
DOW	Dow Inc.
AVGO	Broadcom
CCL	Carnival
WMT	Walmart
XOM	ExxonMobil
CSX	CSX Corporation
C	Citigroup
HPE	Hewlett Packard Enterprise
COIN	Coinbase
WFC	Wells Fargo
VZ	Verizon
CNC	Centene Corporation
FTNT	Fortinet
RF	Regions Financial Corporation
NCLH	Norwegian Cruise Line Holdings
ON	ON Semiconductor
KHC	Kraft Heinz
SLB	Schlumberger
FCX	Freeport-McMoRan
HAL	Halliburton
KO	Coca-Cola Company (The)
BMY	Bristol Myers Squibb
VTRS	Viatris
OXY	Occidental Petroleum
ANET	Arista Networks
LRCX	Lam Research
PANW	Palo Alto Networks
PYPL	PayPal
HST	Host Hotels & Resorts
META	Meta Platforms
DIS	Walt Disney Company (The)
MCHP	Microchip Technology
BAX	Baxter International
ORCL	Oracle Corporation
CAG	Conagra Brands
MRK	Merck & Co.
XYZ	Block, Inc.
SBUX	Starbucks
UPS	United Parcel Service
APA	APA Corporation
MRNA	Moderna
LLY	Lilly (Eli)
NEM	Newmont
DVN	Devon Energy
PPL	PPL Corporation
MNST	Monster Beverage
AES	AES Corporation
NKE	Nike, Inc.
CRM	Salesforce
LUV	Southwest Airlines
JNJ	Johnson & Johnson
KDP	Keurig Dr Pepper
MDLZ	Mondelez International
SCHW	Charles Schwab Corporation
COP	ConocoPhillips
WMB	Williams Companies
QCOM	Qualcomm
WBA	Walgreens Boots Alliance
DAL	Delta Air Lines
CVX	Chevron Corporation
MO	Altria
ABNB	Airbnb
DDOG	Datadog
HPQ	HP Inc.
ENPH	Enphase Energy
JPM	JPMorgan Chase
DOC	Healthpeak Properties
USB	U.S. Bancorp
APH	Amphenol
NEE	NextEra Energy